dichi	DUCIR
faichi	FAUCIR
farki	FARCIR
fênki	VENCIR
foka	VOCAN
hashki	HASCIR
hêshki	HESCIR
kaoka	CAUCAN
kashki	KASCIR
kêshkê	KESCEN
krêshki	CRESCIR
lachê	LACEN
lêshkê	LESCEN
manka	MANCAN
oloka	OLOCAN
prechê	PRECER
rashki	RASCIR
shkolichê	SCOLICER
snuka	SNUCAN
tôshkê	TOSCEN
trankê	TRANCEN
