achupua	achupoa
da	dona
dichi	doki
feriê	fêrsê
fôtê	fêlsê
hizi	hôrsi
ihmêta	ihmêrsa
kêshkê	kêsê
kolaoda	koloda
kudichi	kudoki
laoda	loda
lega	loga
lêshkê	lêsê
mêta	mêrsa
noê	nozê
pua	poa
puga	poga
rênlaoda	rênloda
rênlelê	rênlêlsê
shterê	shtêrsê
sôtê	sêlsê
subra	sôbra
tôshkê	tôsê
